ATM,Stock
Z0276001,0
Z0386002,0
Z0646002,0
Z1031001,0
Z1524001,0
